****************
*         *    *
*    *    *  ***
*    *    *    *
*    *E   *    *
******    *    *
*S   *         *
****************
