*************
*      *   E*
*   *  *  ***
*   *  *    *
*   *  *    *
*** *  *    *
*S  *       *
*************
