*****
* E *
*   *
*S  *
*****
