*********
*E      *
***** * *
*     * *
* ***** *
*     * *
***** * *
*S      *
*********
